D...S........#......
..D....#.....#......
#.......B..#.#......
..D...#......D......
....#........#......
...S......#.#..#..##
.....D.....#........
...#...#..#.........
...................#
